NO ./pics/gnomed.png
SO ./pics/chokbar.png
WE ./pics/gnomed.png
EA ./pics/gnomed.png

111111111111111111111
100000000000000N00001
11111111111111111111
